GGGMMMMMMMMMMMMMMMMMMMGGG
GGGGGGGGGGGGGGGGGGGGGGGGG
GGGWWWWWWWWWWWWWWWWWWWGGG
GGGWDDDDDDDWWWDDDDDDDWGGG
GGGWDDDDDDDW WDDDDDDDWGGG
GGGWDDDDDDDWWWDDDDDDDWGGG
GGGWWWWWWWWWWWWWWWWWWWGGG
GGGGGGGGGGGGGGGGGGGGGGGGG
MMMGGGRRRRRRRRRRRRRGGGMMM
MMMGGGRSSSGGGGSSSSRGGGMMM
MMMGGGRSSSGFFGSSSSRGGGMMM
MMMGGGRSSSGFFGSSSSRGGGMMM
MMMGGGRSSSGGGGSSSSRGGGMMM
GGGGGGRRRRRRRRRRRRRGGGGGG
GGGGGGGGGGRRRRRGGGGGGGGGG
GGGGGGGGGGRRRRRGGGGGGGGGG
GGGGGGGGGGRRRRRGGGGGGGGGG
GGGGGGGGGGRRRRRGGGGGGGGGG
GGGGGGGGGGRRRRRGGGGGGGGGG
GGGGGGGGGGRRRRRGGGGGGGGGG
GGGGGGGGGGRRRRRGGGGGGGGGG
GGGGGGGGGGRRRRRGGGGGGGGGG
GGGGGGGGGGRRRRRGGGGGGGGGG
GGGGGGGGGGRRRRRGGGGGGGGGG
GGGGGGGGGGRRRRRGGGGGGGGGG
GGGGGGGGGGRRRRRGGGGGGGGGG
GGGGGGGGGFRRRRRFGGGGGGGGG
GGGGGGGGFFRRRRRFFGGGGGGGG
GGGGGGGFFFRRRRRFFFGGGGGGG
GGGGGGFFFFRRRRRFFFFGGGGGG
GGGGGFFFFFRRRRRFFFFFGGGGG
GGGGFFFFFFRRRRRFFFFFFGGGG
GGGFFFFFFFRRRRRFFFFFFFGGG
GGFFFFFFFFRRRRRFFFFFFFFGG
GFFFFFFFFFRRRRRFFFFFFFFFG
FFFFFFFFFFRRRRRFFFFFFFFFF
FFFFFFFFFFRRRRRFFFFFFFFFF
FFRRRRRRRRRRRRRRRRRRRRRFF
FFRRRRRRRRRRRRRRRRRRRRRFF
FFRRWWWWWWWWWWWWWWWWWRRFF
FFRRWWWDDDDDDDDDDDWWWRRFF
FFRRWWWDDDDDDDDDDDWWWRRFF
FFRRWWWWWWWWWWWWWWWWWRRFF
FFRRRRRRRRRRRRRRRRRRRRRFF
FFRRRRRRRRRRRRRRRRRRRRRFF
FFFFFFFFFFFFFFFFFFFFFFFFF
FFFFFFFFFFFFFFFFFFFFFFFFF